111111
100201
111001
130001
111101
111111

