10
10
1
100
##########
#        #
#     x  #
#        #
#   ######
#        #
#     o  #
#        #
#        #
##########