10
10
1
10
##########
#  x     #
#        #
###### ###
#      o #
#        #
#        #
#        #
#        #
##########

